12;12
.#.#..#.###.
.#.#.@#..#..
.#.#..#..#..
.#.####!.#..
............
.####..####.
.#..#..#..#.
....#...&.#.
.~..#...###.
.####.....#.
.#.....#..#.
.####..####.
5
A;0;2
B;1;0
C;3;11
D;10;5
E;4;2
5
a;0;2
b;10;2
c;10;11
d;0;2
e;1;0
f;1;0

