10;10
##########
..##..... 
# ####!###
#.      ##
#.#### ###
 .##..@.. 
#.##.# ###
#.##.# ###
#&....~ ##
##########
4
A;1;1
B;1;8
C;8;6
D;6;6
4
a;8;2
b;3;5
c;1;9
d;6;4
